1 4 2 2 3 1
2 1 5 5 1 2
1 2 1 1 2 1
1 1 2 2 1 1
1 0 3 0 1 0