3 1 1 1 1 3
2 1 4 4 1 2
5 2 1 1 2 5
1 1 2 2 1 1
1 0 4 4 0 1
0 1 5 5 1 0